W WW  W W W  W    W WWW  W WWW  WWWW  W W W W    W
 W      W   W  W   W  W W   WWWWWWW   WWWW WW W  W
   WWWWWWWW WWW WW  W   W  WW         W W WWWWWWWW
WW  W       WWWWWW      W       W  W  WWW  WWW  W 
WW W WWWW    WW WW W WWW W W W  WWWWW  WWWWW W WW 
W W  WWWW  W    W    W W WW W WW WWWWWW  WWWW     
WWW WW   WWWWW WWWW  WWWW WWWW     WWW      WW   W
WW     W  WW      WW WW  W    W  WW  WW WW  WW  WW
WWWW W W WW W      W WW WWW W W W W W WW W  W   W 
  WW WW W W  W W  WW  WW W  W   WWWWW  W WWWWW  W 
WWWWWW   WW WWWW    WW WW  WW W   WW W  WW  W  WWW
W     WW  W WWW WW  W W  W W W   WWWW W WWWW   WWW
 W WW  WW WWW W  W   W WWWW W   W W W W  WWW    W 
         WW   W W WWW W WWWWWWWW W  WWWWW  WWWW W 
 W  W WW   W   WW W  WW W WW     WW   W W W   WW W
 WW W W  W W W WWWW    W    WWWW    W W  WWW  W  W
  W  W WWW WW  WWWW WW W WWWW WWWWW WW  W W    W W
WW WW W      WWW  WW WW        W  W   W  WWWW W   
  W WW  WWWWWWWWW W WW W  W W W   WWW WWWW  WW W  
W WWWW W  W  WW   WW     W WW WW W   WWW  W WWW   
W   WWWWW W  WWWW  WWWWWW WW WWWW W WW  WW W   WW 
WW WWW   W W    W   WWWW  WW W  W   W W    WWWWW  
WW   W    WW WW    W        WW W   W W   W    W W 
 W W W W WW  WWWWW  P  WW  W W   WWWWW WW WW W  WW
WW WW W WW  W   W W  WWWWW     W WWW WW WWW W  W  
W WWW  W  WWWW W WW   WWWW WW  WW  WW     WW WW  W
 W   WW  W      W WW WWW W WW WWW W  W WW   W    W
 WW WWWWW W WWW W   W W   W WWWWWW  W WW W     W W
  WW WW WW WWW  W   WWWW W W WWW W WW WWW  W      
  W WWW  W   WWWWW W   W WWWWW WW WWW    WW  W W  
 W W WW W WW W   W  I    WWWW W   W   WWWWWW W W W
 W WWWW WW  W W WW  W W      WWW WW W WWWW WW  WW 
WW     W WWW W WW    WWW  S  W W W     WW  W    WW
 W    WW  W   WWWW WWW  WW WWW WW   WW   WW WW W  
   WW   W  WWW WW  W   WW W  W  W  W  WW WWWW W WW
W   WW   WW W W W     WWW   WW WW WW W W   W W   W
WWW    WWW W   WW WW  WWW WW   W WW  WWWW WWW WWWW
W         WW  W WWW WW  WW  W   W W  W  WWWWW  WW 
W WW  W W W W      WW WWW  W WW W  WWW   W   W   W
W  W W WWWW  W W   W W  WW WW  W    WWWWWWWWW   WW
W W    WWW W W  W W  WW W    WWWW W W W WWW     WW
 W  W    W    WWW    W W  WWWWW        WW W  W W  
WWWW W W W  W WW WW W W W   W WW   W  W WWWWWWW WW
       WW W  W WWWWW  WWWW WWW WWWWW W W WW  W W  
 WWWW WWWWWW  WWW W W W       W   WWW  W W W     W
WWW WWW  WWW WW W  W       W     WWWWW  W WWW   W 
W    WWWW WWWWWW    WWW   W   W WWWWWWWWW   WWW  W
W W  WW  W  W W WWW   W         WWWW  WW W WW   W 
 W WW W  WW W W     W  W    W WW WW W WW WW W WWW 
     W WW WW   W     W   W W    W  W W     W W  WW