  W  WWWW W W W WWWW WW      W   W W WW   WWWWW  W
W  W  WW  W      WW  W W   W    W W  W WW  W  WW  
  W   W WW   WW  WW WWWW W  WWW   W WWW  WWWW WWW 
 W  WWWW WW  WWW  W   W      WWW  W     WWW  W  WW
  W W     W WW W W WW   WWWWWW WW      WW WWWWWW  
WW  WWW    WW  W       W WWWW WW W WWWWWW W WWW WW
 W   WW  W W WWW P  WW  WWWW  WWWW  W W WW WWW   W
 WW    W W  W   II   WW WW  W WWW WWW WW W  W  W W
WWWW WWWWW  WW WWWW I WWWW W  W WW W WWW  W WWWW  
    W WWWWW   WWWW WWWWW W WW   W  WWW    WW   WW 
   W WWWW   WWWW WWWWWW WWWWW  W WWW   W W  WW W  
 W  W W W    WWW  WW W WWWW  WWWW W W    WW    W  
  WW WWWWW W WWWW  WW    W W W W WW WW   WWWW W   
WW WW W W WWWWWW WW WWWWW     W  WW    W    W W   
W    W WW  WWW W WW  WW WW W W WWW WWW  W    W  W 
 WWWW W  WWW  W WW WW  W    WW  W W WW  WW WWW WW 
 WWW     WWW  W W W  WWWW         WWWW W  WW W  W 
W      WWWW      W   W   W W W  WW  W WW W   WW W 
 WW  W     WWW WWW WW  WWW WW   WWWW WWW   WW    W
WWW  W  WWW  WW  W WWWW     WWWWW  W  W   WWW WWWW
WW WWWWWW  WW  WWW WW W WWWW WW W W   WW   WWWW  W
WW W  WWW  W WW W W   WWWW W W W  W W W  WWW     W
  WWW    W WWW  WW   WW   WW W W WWWWW WW  WWW   W
W W W  WWWW W WWW      WW    WWW  W W    WW  WW   
 W   W    W W W  W W WWWW WW  W  WW WWW    W WWWWS