W  W W   W   WWW WW  W   WW WW    WWWWW WWW W  WW   W W W  WWWW   W  W W  W WWW   W W W W W  W   W  
 W   WW WWWWW WWWW  WWW  W  W   W W W W W   WWWWWW WW  W  WW     WWWW W WW    W WW  WWWWW W WW W W  
WWW W WW      WWW WW W WW W  WWWW WWWWW WWWW       WWWWW WWWWWW W WWW W  WW W W W   WW  WW  W W  W  
WW W WW W  WWWWW  W WWW WWW W   WW WW   W     W WW   WWWW   W WW    WWWW W  WWW WWWWW   WWW  W W W  
 WW       WWW W     WW WWW W    W  W  WWWW W WW  W    WW W  WWWWW   W      WW   WWW WW   WWW  WW    
W W   WW  W  W WW WWWW  WW   WW WWWW WWWWWWW    W  WW WWWWW WW      W  W W W WWWW     WWW  W WWW   W
 W W   W W  W  WWWWW WWWWW    W  W  WWW W W W    WWWWWW  WWWW  W W W   WW WW  W WW WWWW WW W  WW    
  W  WWWW     W    W WWWWWWWW W W   WW  W W    W W  W W W WWW WW WW WWWW W WWW W     WW WW W  WWWWW 
 WWW    W W  W    W  W  W WW     WW WWWW W WWW  W    W  WWW   WW W WW    WW W   W WW W WWWW  W W W  
  WW   WWWWWW W WW    W WWWWW   WWWWW  W W WWW W WW WWW WWWWW W  W  W  W  WWW W WWWW W   W WW WW    
 W   WW    W  WWW W WWWWWW WW     WW  W W WWW  W     W    WWW WW W W W  W W  W     W  W  W   WWWWW  
  W  WW WWW WWWWW    WW  W  W WW  WW   W WW   WWWW         W   W W  WWWW  WW W W   W WW WW  W  WW W 
W  WW    W W  W  W W W WWW W    W   WW  WW WW W  W WW  WW W W     W   WWWW  W WW WWWW  WWW    WWW W 
 WWW   WWWW W WWWWW W WW    WW W WWW W   W   WW   W WW   W W W WW   WWWW     W W WW W  W WWW  WWW  W
 WW   W W       WW  WW W WWW    W  W W     WW     WW WWW  W WW W     WW    WWWWWWWWWWW    WW WWWWW W
WWWW   W  WW WWW W W  W W   WW  WWWWW WWWWW  WW  W W WW   W WWW    WWW    W WW WWW W    W  WWWWWWW W
W WW W W  W W    W W W WWW W W   WW WWWW   W  W   WWW   W     WWW WW   WW    W WW  WW W W    W   W W
W    WW W  W W WW  W  W  WWWW   WW WW W W   WWWW  W W W W W WWWWW   WWW WWWW W W     W     W   W W W
 WWWWWW   WW  WWW  W WWW W   W WW  WWWWWW WWWW  W W   W   WWWW WW WW   W WWW WWWW W   W  W      WW W
  WW WWWWWW WWW  WW  W  WWWWWWW          WWWW WWWWWWWWW  WWW      WW     W   W W  W  W    WW   WW  W
WW  W  W W WW W   WW  WW   W    W  WWWWWWW  W   W    WWWWWW  W    WWW    WW W WW WW WWWWWW  WWW    W
W WWWWW    WW W WWW WW W WW  W W       W  WW  W W W WWW WWW    WW  W W  WWWW  WW   WWWW  W W WW W WW
     W    WW  WW WWW  WW  WWW W  W  WW W WWWW     W   W WW       WW    W  WWW  WW       WW  W  W W  
 W WW    WW W   WW   W  WW   W WW   W  W WW W WW W WW       W WWWW     W W    WWWW  WW  WW  W W W   
  W WW   W  WW WW   W   WW  WWW WW WWWW WW    W  WW   WW W WW W WWWWW   WWW WW    WW     WW W W    W
 WW WWWW W  W  W WWW WWW WW WW   W  WW    W  WW  WWWWW    W  W W  W  WWWW W W   WW WWW WW  WWWWW W  
 W W  W     W WW WWWWW    W W    WWWWWWWWWWW  W   WW  W WWWWW  WW   WW W WWW  WWW   WWWW W W  WW  WW
WW W  W   W     WWW  WW WWWWW   W WWWW W  W W WW    W  W W    WWWW  W  W W WW  WW W  WWW      W   W 
WW   WWWW  WWWW WWWWWW W W WW    W  W  W   WWW WWWWW WWW W   W          WWW   W  WW  W   WWW   W W W
  W W   W W   WWW   W WW WW  W W  WW  WWW WWWWWW  W  W W WWW WW   W  W WW  WW WW    WW   W W W    WW
 WWW  W WW WWWW W  W W WWW W  W   W WW    W WWWWW WWW  W        W   WW     W    WWW   W W    WWW  WW
    WWWWW W W W  WW WWWWWW W WW W WWWWW   W WW   W   W  WWWWWWWWW     WWWW WWWW  WW  W WW    W  WWW 
  WWW  W WWWWW  WWW WW  WW WWW  W  WW   W             WWWW WWW W W WWW WWWWWW  W W WW  W WWWW   WW W
W WWWW  W  W W  WW WW W WW W WWWWWW   WW W WW   WW      WWWW  WW   W WW W WW   WWWWW WW WWW  W WW WW
   W  WW WW  W W W  W  W  W   W W W     W  WWWW WW W W WW WWW  WW  W  W  W  W W     WWW  W W   WW  W
WWW WW    WW WWW W  W WW WWWWWW W W  W W  W W   W  W  WWW WWWW   W  WW WWWWW W W WWW W WWW WW       
 W   WW  W  WWW W  W W W WW   W WWWW WWW WW W      WW WWWWW WWW    W       WWW W  W WW W WWWWWWWWW W
 WWW WWWW  W     WW  W WW    WW  WW  WW     WWW  W  W WWW W  WW WW   WWW   WWWW   W   WW WWWWW    WW
WWW      WWWW   W  W  WWW   WWWW W  W  WW  W     WWWW WWW   WWW   W  WW W     W   W    WWW  WW  W  W
WW   WW  WWWW  WWW  WW W WW W W WW WWWW   W   W  W W W  WWW    WWWW W   WW W WWWWWW  WW  WWW WW W WW
W WWWW    WWW    WW W WW  WWW WW WWW    WW W    WWWW WWW     W   WW  W W  WW WWWW W   WW WW  W      
W  WWWWWW  W WW  W  WW W  W  WW WW WW     W W W W WWWW    WWWWW  WW      WW    WWWWW W W WWW  W W  W
WWW   W       W W   WWWW W      W WW WWW  WWWWWW   W   WW    W     W  W  WW  W   W  W W W W W WW WWW
WW W  WW  WWWWWW W  W     WWWW    W   WWW W W  WW WWWW WW W W  WW W   W  WWWW W W    W W      WW  WW
W    WWWW WWW W  WW W  WWW WWWWW WW   WW WW    W W  WWW  WWW    WWW     W WWW   WW  W WWW   W  WWW  
 WWW   WWWWWWWW W  WW  W  WWWW    W  W  WW       W W  W WWW W W  WWW WWWW W WW    WW WW W WW   WWW  
  W   W  WW    W  W     WW W  W   WWWWWW   WWWWWWW  WWW  W W WWW W      W W   WW  WWW  WWW     W WWW
  WWW WWWWW    W WWW W W WW WW  W    W W W WW W W WWWWW     WWWW W WWWWW  W    W WW   W WW  W   W   
 W W  WWWW WWW  WW WW W  W WW     W W  WW WWW   WW     WW WWWW  W W WWWWW WWW WWW  WW  WW   WWW     
   WW W    WW    W     W  WWWW  WW   WW  WW  W WWW WWWWW  W  WW    WWW WWWW   WWW W W WW     W  W  W
     WW    W W      W WWWW      WW   WWW  W   WW    W WWWW W  W   W  W W  WWW  WWW WWWW W W  W      
     WW  WW  W W WWWW WWWW  W       W   WW   W  W WW  W  WW W WW W W  WWWW  W  WW WW W  WW WWW  WW  
  W  W W        WWW  WWW    WW W W   WWW W WWWW W W WWW WWW W  W   WW WW  WWWWWW    W W WW W   WWWWW
W  WW   WW WWWWW      WW     W  W WWWWW    W WW W  W   WW WW   W     W    WWWW W   W W W WWWW  W WWW
 WW        WW  W WWW W WW    WWWWWWW  WW   W WW   W    W WWW   WW WWWWW  W W WWW W W WW  W W W WWWWW
WW   W  W   W WW W W   WW      WW WW  WW WWWWWW WWW      WWW WWW WW  WW    W WW  WWW  WWWWW  WW WW W
WW  WW   WW   W W     W  W W W W W   WWW      WWWW WW WWWWW WWWW W W W W    WW     W W  WW  W W  W W
WWW WWWWWWWWW    WW  W WWW WWWW W WWWW W W WW W    W    W   WW W WWW   W W W W  WW  W W WWW W  WWW  
WW       W W W   WWW    W W   WWW W  W WWWW  WWWW   W WWW W W WWWW W W W  W W W WW  WWW  WW WWWW W  
 W W  WWW WWWW WW WWWW   W W WWW WWWW W  WW WWW WW WW W  WW W WWWW WW   W W    WW W  W   WWWW  WW WW
    W WWW   WWW W    W  W   W   W W WW WWW    W WWWWWW W W W      W W W WW     WWWW   WWW  WWW WW   
 WW W W WW WW   W     W W   W    W  W     WW    WWWW   WWWW   W  W   W   W WWWWW       WWWWW    W   
 W WWW WWW WWW    WW     W  WW   W W  WW     WWWW   WWW WWW  WW   W WWWW WW  WW   WW W  WW W    WW W
WWW   WW  WWWW WWWWWW W W W  W W     WWW  W  W WW  WW   WW WWW      W   WWWWWW   W WWWWWWW  W W   WW
W W    W  WWWW     W WWWW WW  W   WWW WWWWW W  W WWW WW  WW W   W   WW W     W   WWW W W   W W    WW
 WW   W     W WW WW   W    W   WWW WWW WWWWW W WW W WW        WW     W  WWWW W   W  W W W   WW  W W 
WW WW   W W  W WW WW WWW W W WW  WW  WWWWWW W W W  WW      W     W W WW  W  W W  W WWW W W WWWWW  W 
WW WWW WW W   W   WWW   WWW WW W WWWWW  W   WWW W   W  WWW WWWW  WWW W W     W WWW WW W  W     WW WW
W   WWWW WWW  W    W  W   W  W  W W WW W WWW   W  WWWW    W W W W W   WW W  WWWW W  WWWW  WWWW  WW W
  W    WWWWWWWWW  WW WW  W  W W WW WWWW W WW     WWW WWWWW WWW WWW W   W WW   WWWWW  W WWW  WWWW W  
WWW      WW  W    WWW W  W W W   W WWWW W   WW W W  W W     W W W   W  WW  W      WW WW  WWW W WW W 
 W W  WW  W  W  W    WW    WW     W W WWW WWWWW   WW    W WW    WWW     WW  W      WW  W   WW WW  W 
W  W W WW          W W W    WW W  W WWW    WW  WWWWWWW      W  WWWWWWWWWWW     W   W W  W W W  WW W 
WW  WWWWW   W   W WW   WW    W  WWW  W W    W W  WWWW WW WW WWWW   W W  WWW WW W WWWW   WW W  WW WWW
 WW WW WW W   W    W WWWWW WW W WWWWW   W WWW  W  W W     W W  WWW   WW W WWW WWW W  WWW  WW W  W WW
W WW W    W WW W   W WWWWWW W  WW WWWW  WW   W W    W  W W WWWWW WWWWW  W WW   W   W   WW W   WW   W
    WWW W WW  W W WW W W    WW    W    W WW W   W      W WWWW     WW   WWWW WWW   W W W W   W W W  W
 W     W  W  W WWW  W  WWW WWWW WW W   WWWW  W W W WWWWW   WWW  WWWW WWW W  WW WWWWW   W  W WW  WW W
   WWWWWWW WW  W WW   WWWWWW W  WWWWW W  W WWW W W W W    W W WWWW WWW W W W WWW        W W    WWWWW
W  W      W  W W WWWW W     W W     WWWWW   WW WW  W   W      WWWWWWW W W    W WW W  WW W WW   W  W 
W WW   WWW W    WW    WW W    W  WW WWW  WW W W W W   W  WW          W W     WW WWW   WWW  W W W    
  W WW   W   WW WW   W      WW  W  W  WWW    W W W WWW W  W WWWW   WWWW W WWW WWW     WW  W     WWWW
 W     W   WWW  WWWWWW   WWW  WWW WWWWW    WW W  W W  W   W  W W    W   W WW WWWW W W WW W WWW W    
W W W W  W  W  WWWW WWW WWWWW      WWP   WW WWWWW W   WWW WW  WW W WW WW WWWWWW   W W        W W WWW
WW W   W  WW  WW W  WW  WWWWWW     W WI     W W WW W W   WW W  WW WW WWW    WWWW  WWW    W  W    W W
W        W WWW WW  W W   WWW  WWWWWW   W WW    WW WWWW  W WW W     WW   W     W    W W  W W   WW WWW
 WW   W       W W  WWWW W     W W W WW WS WWW   WWW W WW WWW WWWW  W  W WWW W WWWW W WWW  W WWW  W W
 W   W WWW W  WW WW W WW W     WWWW WWW W W WWW  W W W   W W WW  WW W WWWWW  W W W  W W W WW   W  WW
W  W  WW  W W  W WW WW     W  W W  W  WWW  WWWW  WWWWW W  WW W WWW W  W W   W   W  WWWW  WW W W WWW 
  WWWW  W    W W   WWW  W WW WW      WW WW   WWWWWW    WWWWW W      W W W  WW       W W  WWW    W  W
   WW  WWWW WWW       WW  WWWWWW W WWWW W  WW  W W WWW W  WW WW    WW  WW W   WWW  WW W WW    WWW   
 WWWW   W WWW   W  WWW W W WW W WWWW WW   W WWWWW W W WW W  W    W WW   W     W  WW W W WWW W     W 
W WW W W         WWW      W WWWW    W  WWWW W WW WW   W WWWWWWW  WW W  W W       WW W W W W  WW   WW
W WWW WW W W    W W W WW W W  W W W   W  WWW  W      WWWW   WW   WW WW W     W W   W WWWWW   W   WWW
W WW W W  W WW WW    WW  WWW   WW WWWW  WW     W W  WWWWWW  W W WWW   WWWW W WW W  WWW  WW  WW W WWW
W    W WW WWWW    W    WW WWWW  W WWW WW  WWWWWW WW   WWWW WW   W W WWW WW     W    WWW  W W  W  W W
 W W    WWWWW W  WW WW  W   WW   WWWW  W  WW        W WW W WW W WW  W W WW  WWWWW  W W   W  W WW W W
   W   WWWW    WWWW WW WWWWW  WW         W W   W  W   WW WWW WWWWW    W   W  W WWW  WWW W W WWW  W  
 W WW W W WW    WW WWWW   W  WW  W WWWWW     WWW WW WW WW  WWW   W WWWW  W WW W       WW W WWWWW   W
      WWW   W W    W W W WWWWWW WWW  WWWW  W WW W W   WW   W  W  WWWWW W  W W  W W WWWWWWW WW   WWW 