WIIII II WWII WWIWIW
II I  I IWIIWWW W WW
W W PI WIWWW II  I  
I WWIII III IW  I I 
IW WW  I I  II  W WI
WWII IWIIIWIIW IWWIW
WIWIW W   II  II IWW
IW   II WWWW IWIIWI 
WWIIIWIIWI II  W W I
 WWII I W IIWWII  I 
I I  IWIIWW W WI III
I IIW W I  IWI   III
 IWIW IWWWIWIIWWW  I
 IWWWWII WWW WW WIWI
  WI IIIW  I  WIIW W
WWI  I II W IW   WI 
 IIII I W I I IWW WI
IWW  I WWWI  W  IIW 
  II I I I IWWW II  
W  IWII  IWIWIIWIS I