P  I  I  W   W IWWW IWWWW
 WWWI W   I IWIIWW   WIIW
WIW  II W    I WW I WIIIW
 IW   IWIW I WIWI   WW IW
WIWIWWI  WIIIWIWIW   I IW
IIWIIWI  III  WIIW I I II
  WII  WW   IWWIWIIWW  IW
I  W  W II WWW W IW  IWW 
IW IWWIWIW I   II WI W WW
   WWIWWWW  IIW WWWW W WI
 I WWIW  IW WIW WIIW W WW
W WW I IIIW  I       WIIW
 WIW W WIW WI  I IWIIIIIW
W  IW IW   IIWW  WI WWIW 
IIIWIWWI  WWWWWWWWWW WW I
W I WI IWWWWWIWW  IW  WWW
II WWIWWWW  I I II WIWW I
WIW WII I WII  IIWIW  I I
WI II II W W W WW     WW 
WI II W WI     IWW WII  S